############################################################
#1111111111111111111111111111111111111111111111#11111111111#
#1111111111111111111111111111111111111111111111#11111111111#
#1111111111111111111111111111111111111111111111#11111111111#
#1111111111111111111111111111111111111111111111#11111111111#
#111111#####################################################
#1111111111111111111111111111111111111111111111111111111111#
#1111111111111111111111111111111111111111111111111111111111#
#1111111########################################11111111111#
#1111111111111111111111111111111111111111111111111111111111#
#11111111111111111111111111111111111111111111111111##111111#
#1111111111111111111111#########################111##111111#
#1111111111111111111111##111111111111111111111##11111111111#
#1111111111111111111111##111111111111111111111##11111##1111#
#1111111111111111111111##1111111111111111111111111111##1111#
#1111111#11111111111111##1111111111111111111111111111111111#
#1111111#11111111111111##111111111111111111111111111111##11#
#1111111#1111111111111111111111111111111111111111111111##11#
#1111111#1111111111111111111111#################11111111111#
#1111111#11111111111111111111111111111111111111#11111111111#
#1111111#11111111111111111111111111111111111111111111111111#
#11##111#########################1111#11#111111111111111111#
#11##111#1111111111111111111111111111#11#111111111111111111#
#1111111#111111#######################11#11111##############
#1111111#111111###1111111111111111111#11#####1##############
#1111111#111111###1111111111111111111#11111111##11111111111#
#1111111#1111111111111111111111111111#11111111##11111111111#
#111111111111111111111111111111111111111111111##11111111111#
#111111111111111111111111111111111111111111111##11111111111#
############################################################
